GGggGGGGGGGGTT
WTGGGGggGggGGT
WWWWWWWWWTggGG
WWWWWWWGTGgGGG
WWWWWWWWGggGGG
WWGGGGGTGGgGGG
TGGGGggGGgggGG
GggGGGHGgTggGG
ggGGGTPTGGTggG
GGMMMPPGGGGGGT
GGGMMPGGHG789T
GGGMGPGPPG456G
GPPPPPGPGG123G
GPGTPGGPGHGPGG
TPTTPPTPPPPPGT