GGggGGGGGGGGTT
WTGGGGggGggGGT
WWWWWWWWWGggGG
WWWWWWWGGGgGGG
WWWWWWWWGggGGG
WWGGGGGGGGgGGG
TGGGGggGGgggGG
GggGGGHGgGggGG
ggGGGGPGGGGggG
GGMMMPPGGGGGGT
GGGMMPGGHG789T
GGGMGPGPPG456G
GPPPPPGPGG123G
GPGTPGGPGHGPGG
TPTTPPTPPPPPGT